48,64
9999999999999999999999999999999999999999999999999999999999999999
9000000080000000000000000000000000000000000000000000000000000009
9000000000000000333333333333330000000000000000000000000000000009
9000000000000000000000000000000000000000000000000000000000000009
9000000000000000000700000000000000000000000000000000000000000009
9000000000000000000000000000000000000000000000000000000000000009
9000000000000000000000000000000000000000000020000000000000000009
9000222222222222222222000000000000000000000020000000000000000009
9000000000000000000000000000080000000000000020000000000000000009
9000000000000000000000000000000000000000000020000000000000000009
9000000000000000000000000000000000000000000020000000000000000009
9000000000000000000000000000000000000000000020000000000000000009
9000000060000000000000002000000000000000000020000000000070000009
9000000000000000000000002000000000000000000020000000000000000009
9000000000000000000000002000000000000000000020000000000000000009
9000000000000000000000002000000000000000000020000000000000000009
9000000000000000000000002000000000000000000020000000000000000009
9000000000000000000000002000000000000000000020000000000000000009
9000000000000000000000002000000000000000000020000000000060000009
9000000080000000000000002000000000000000000020000000000000000009
9000000000009000000000002000000000000000000020000000000000000009
9000000000000000000000002000000000000000000020000000000000000009
9000000000000000000000002000000000005000000020000000000000000009
9000000000000000000000002000000000000000000020000000000000000009
9000000000000000000000002000000000000000000020000000000000000009
9000000000000000000000002000000000000000000020000000000000700009
9000000000000000000000002000000060000000000020000000000000000009
9000000007000000000000002000000000090000000020000000000000000009
9000000000000000000000002000000000000000000020000000000000000009
9000005000000000000000002000000000000000000020000000000000000009
9000000000000000000000002000000000000000000020000000000000000009
9000000000000000000000002000000000000000000000000000000000000009
9000000000000999999999999999999999000000000000000007000000000009
9000000000000000000000002000000000000000000000000000000000000009
9000000000000000000000002000000000000000000000000000000000000009
9000000020000000000000002000000000000000000050000000000000000009
9000000000000000000000002000000000000000000000000009000000000009
9000000000008000000000002000000000000000000000000000000000000009
9000000000000000000000002000000000000000000000000000000000000009
9000000000000000000000002000000000000000000000000000000000000009
9000000000000000000000000000000000008000070000000000000000000009
9000000000000000000000000000000000000000000000000050000000000009
9000000000005000000000000000000000000000000000000000000000000009
9000000000000000000000000000000000000000000000000000000000000009
9000000000000000000003333333000000300000000000000000000000000009
9000000000000000000000000000000000000000000000000000000000000009
9000000000000000000000000000000000000000000000006000000000000009
9999999999999999999999999999999999999999999999999999999999999999